111111111111111111
100000H00000000001
10100101C000PE0011
110100100101010101
111111110111111111
111111110111111111
111111110111111111
111111110111111111
111111110111111111
111111110111111111
111111110111111111
111111111111111111