1111111111111111
1000010000100001
1C10000C00000001
1010000000100P01
1E11111C11100001
1111111111111111