111111
10P001
10E001
10C0H1
111111