11111111111111111111
11000000000000000011
10000000100000000001
10000000000000000001
10000000000000000001
10000000C00000000001
10000000000000000001
10000000000000000001
10000000000000000001
10000000E00000000001
1000000000000C000001
11000000P00000000011
11111111111111111111