1111111111111111111111111111111111
1000000000000000000000000000000001
1000P000000000000000000000C0000001
1000000000000000000000000000000001
10000C0000000000000000000000000001
1000000000000000000000000000000001
1000000000000000000000000000000001
1000000000000000000000000000000001
100000000C000000000000000000000001
1000000000000000000000000000000001
1000000000000000000000000000000001
1000000000000000000000000000000001
1000000000000000000C00000000000001
100000000V000000000000000000000001
1000000000000000000000000000000001
1000000000000V000000000000000C0001
1000000000000000000H0000000E000001
1000000C00000000000000000000000001
1000000000000000000000000000000001
1111111111111111111111111111111111