1111111111111
10C1001C000C1
1000011111111
100011E000001
1000110000001
1000000000001
10000000P0001
1111111111111