1111111
1010001
10110C1
1E00P01
1111111