11111111
1001C001
100110C1
10E00P01
11111111