11111111
10H1C001
100110C1
10E00P01
10000H01
11111111`