1111111
1010001
1010001
1000001
1111111