11111111
10H1C001
100110C1
10E10P01
10010001
10010001
10000001
11111111